7 1 1 1 1 1 1 1 1 1 1 1 1 1 1 8
2 0 0 0 0 0 0 0 0 0 0 0 0 0 0 2
2 0 7 1 1 1 4 0 0 6 1 1 1 8 0 2
2 0 2 0 0 0 0 0 0 0 0 0 0 2 0 2
2 0 5 0 3 0 7 1 1 8 0 3 0 5 0 2
2 0 0 0 2 0 2 0 0 2 0 2 0 0 0 2
2 0 0 0 2 0 10 1 1 9 0 2 0 0 0 2
2 0 3 0 5 0 0 0 0 0 0 5 0 3 0 2
2 0 2 0 0 0 0 0 0 0 0 0 0 2 0 2
2 0 10 1 1 1 4 0 0 6 1 1 1 9 0 2
2 0 0 0 0 0 0 0 0 0 0 0 0 0 0 2
10 1 1 1 1 1 1 1 1 1 1 1 1 1 1 9